11111111111111111111
1200000000C00000C001
1C000000000001100001
10000100000001100001
100001100020010C0001
1000000C000000000001
100100000000000000C1
100C0111110000C00201
100011E0000000000001
100000000C001100C101
100C001100000C000101
10010000000100001101
1C00000100P000C00001
100000000C0000000021
11111111111111111111