11111111111
1E000000001
10100101001
10100000101
1P00C0000C1
10100101001
1000010C001
1010C000001
10100100101
10000001001
11111111111